1111111111111
1111000000001
1C100000000P1
1000000000001
1111111111111