1111111111111
1111000000001
11100000000P1
1000000000E01
1111111111111