1111111111111
1111000000001
11100000000C1
100PP00000E01
1111111111111