1111111111111
1111000P01001
1C00000001001
100000E001C01
1111111111111